26 26 26 26 26 26 26 26 26 26 26 26 26 26 26 26 26 26 26 26 26 26 26 26 26 26 26 26 26 26 26 26
26 26 26 26 26 26 26 26 26 26 26 26 26 26 26 26 26 26 26 26 26 26 26 26 26 26 26 26 26 26 26 26
26 26 26 26 26 26 26 26 26 26 26 26 26 26 26 26 26 26 26 26 26 26 26 26 26 26 26 26 26 26 26 26
26 26 26 26 26 26 26 26 26 26 26 26 26 26 26 26 26 26 26 26 26 26 26 26 26 26 26 26 26 26 26 26
26 26 26 26 10 11 12 13 10 11 12 13 10 11 12 13 10 11 12 13 10 11 12 13 10 11 12 13 26 26 26 26
26 26 26 26 14 15 16 17 14 15 16 17 14 15 16 17 14 15 16 17 14 15 16 17 14 15 16 17 26 26 26 26
26 26 26 26 18 19 20 21 18 19 20 21 18 19 20 21 18 19 20 21 18 19 20 21 18 19 20 21 26 26 26 26
26 26 26 26 22 23 24 25 22 23 24 25 22 23 24 25 22 23 24 25 22 23 24 25 22 23 24 25 26 26 26 26
26 26 26 26 10 11 12 13 10 11 12 13 10 11 12 13 10 11 12 13 10 11 12 13 10 11 12 13 26 26 26 26
26 26 26 26 14 15 16 17 14 15 16 17 14 15 16 17 14 15 16 17 14 15 16 17 14 15 16 17 26 26 26 26
26 26 26 26 18 19 20 21 18 19 20 21 18 19 20 21 18 19 20 21 18 19 20 21 18 19 20 21 26 26 26 26
26 26 26 26 22 23 24 25 22 23 24 25 22 23 24 25 22 23 24 25 22 23 24 25 22 23 24 25 26 26 26 26
26 26 26 26 10 11 12 13 10 11 12 13 10 11 12 13 10 11 12 13 10 11 12 13 10 11 12 13 26 26 26 26
26 26 26 26 14 15 16 17 14 15 16 17 14 15 16 17 14 15 16 17 14 15 16 17 14 15 16 17 26 26 26 26
26 26 26 26 18 19 20 21 18 19 20 21 18 19 20 21 18 19 20 21 18 19 20 21 18 19 20 21 26 26 26 26
26 26 26 26 22 23 24 25 22 23 24 25 22 23 24 25 22 23 24 25 22 23 24 25 22 23 24 25 26 26 26 26
26 26 26 26 10 11 12 13 10 11 12 13 10 11 12 13 10 11 12 13 10 11 12 13 10 11 12 13 26 26 26 26
26 26 26 26 14 15 16 17 14 15 16 17 14 15 16 17 14 15 16 17 14 15 16 17 14 15 16 17 26 26 26 26
26 26 26 26 18 19 20 21 18 19 20 21 18 19 20 21 18 19 20 21 18 19 20 21 18 19 20 21 26 26 26 26
26 26 26 26 22 23 24 25 22 23 24 25 22 23 24 25 22 23 24 25 22 23 24 25 22 23 24 25 26 26 26 26
26 26 26 26 10 11 12 13 10 11 12 13 10 11 12 13 10 11 12 13 10 11 12 13 10 11 12 13 26 26 26 26
26 26 26 26 14 15 16 17 14 15 16 17 14 15 16 17 14 15 16 17 14 15 16 17 14 15 16 17 26 26 26 26
26 26 26 26 18 19 20 21 18 19 20 21 18 19 20 21 18 19 20 21 18 19 20 21 18 19 20 21 26 26 26 26
26 26 26 26 22 23 24 25 22 23 24 25 22 23 24 25 22 23 24 25 22 23 24 25 22 23 24 25 26 26 26 26
26 26 26 26 10 11 12 13 10 11 12 13 10 11 12 13 10 11 12 13 10 11 12 13 10 11 12 13 26 26 26 26
26 26 26 26 14 15 16 17 14 15 16 17 14 15 16 17 14 15 16 17 14 15 16 17 14 15 16 17 26 26 26 26
26 26 26 26 18 19 20 21 18 19 20 21 18 19 20 21 18 19 20 21 18 19 20 21 18 19 20 21 26 26 26 26
26 26 26 26 22 23 24 25 22 23 24 25 22 23 24 25 22 23 24 25 22 23 24 25 22 23 24 25 26 26 26 26
26 26 26 26 26 26 26 26 26 26 26 26 26 26 26 26 26 26 26 26 26 26 26 26 26 26 26 26 26 26 26 26
26 26 26 26 26 26 26 26 26 26 26 26 26 26 26 26 26 26 26 26 26 26 26 26 26 26 26 26 26 26 26 26
26 26 26 26 26 26 26 26 26 26 26 26 26 26 26 26 26 26 26 26 26 26 26 26 26 26 26 26 26 26 26 26
26 26 26 26 26 26 26 26 26 26 26 26 26 26 26 26 26 26 26 26 26 26 26 26 26 26 26 26 26 26 26 26